D:10,B:5,T:3
WWWWWWWWWWWWWWWWWWWWWWWWWW
W     WWWWWWW            W
W      WWWWAAAAAAAAWWWWWWW
WWWW   WWWWWWWWWWAAWWWWW W
WW                   W   W
WWWWWWWWWWW WWWWWWW      W
WW                W      W
WWWWWWWWWWWWWWWWWW      WW
WW               AAAAAAAAW
WWWWWWWWWWWWWWWWWAAAAWWWWW
WW                       W
WWAAWWWWWWWWWWWWWWWWWWWWWW
WWAAWWWWWW               W
WW         WWWWWWWWWWWWWWW
WWWWWWWWWWWWWWWWWWWWWWWWWW