D:20,B:5,T:2,P:5
WWWWWWWWWWWWWWWWWWWWWWWWWW
W     WW  WWW          AAW
W      W   AAAAAAAAWWWWW W
WWWW   WWWWWWWWWWAAWWWWWWW
WW                   W   W
WWWWWWWWWWW WWW          W
W   AAA       W          W
WWWWWWWWWWWWWWW         WW
W   AAA       WAAAAAAAAAAW
WWWWWWWWWWWWWWWWWWAAAWWWWW
WW               WAAA    W
WWAAWWWWWWWWWWWWWWWWWWWWWW
WWAAWWWWWW            AAAW
WWAAAAAAAA WWWWWWWWWWWW  W
WWWWWWWWWWWWWWWWWWWWWWWWWW