WWWWWWWWWWWWWWWWWWWWWWWWWW
WD D  WWWWWWW            W
W      WWWWAAAAAAAAWWWWWWW
WWWW   WWWWWWWWWWAAWWWWW W
WW   D         D     W   W
WWWWWWWWWWW WWWWWWW      W
WW                W      W
WWWWWWWWWWWWWWWWWW      WW
WW              AAAAAAAA W
WWWWWWWWWWWWWWWWWAAAAWWWWW
WW                       W
WWAAWWWWWWWWWWWWWWWWWWWWWW
WWAAWWWWWW               W
WW         WWWWWWWWWWWWWWW
WWWWWWWWWWWWWWWWWWWWWWWWWW