WWWWWWWWWWWWWWWWWWWWWWWWWWWWWW
WD D DWWWWWWWDDDDDD     D WWWW
WD D D WWWWWWWWWWWWWWWAAAAAAAAWWWWWWW
WWWW   WWWWWWWWWWWWWWWWWWWWW      D W
WW                        D        W
WWWWWWWWWWWWWWWWWWW            D    W
WWDD          B               D      W
WWWWWWWWWWWWWWWWWWWWWWAAAAAAAA      W
WWDD                  AAAAAAAAA DD W
WWWWWWWWWWWWWWWWWWWWWWWWWWWWWWWWWWWW